0: 00000000
1: 00000001
2: 00000010
3: 00000011
4: 00000100
5: 00000101
6: 00000110
7: 00000111
8: 00001000
9: 00001001
A: 00001010
B: 00001100
C: 00001101
D: 00001110
E: 00001111
F: 00010000
G: 00010001
H: 00010010
I: 00010100
J: 00011000
K: 00011001
L: 00011010
M: 00011100
N: 00011101
O: 00011110
P: 00011111
Q: 00100000
R: 00100001
S: 00100010
T: 00100100
U: 00101000
V: 00110000
W: 00110001
X: 00110010
Y: 00110100
Z: 00111000
a: 00111001
b: 00111010
c: 00111100
d: 00111101
e: 00111111
f: 01000000
g: 01000001
h: 01000010
i: 01000100
j: 01001000
k: 01010000
l: 01100000
m: 01100001
n: 01100010
o: 01100100
p: 01101000
q: 01110000
r: 01110001
s: 01110010
t: 01110100
u: 01111000
v: 01111001
w: 01111010
x: 01111100
y: 01111101
z: 01111110
 : 01111111
.: 10000000
,: 10000001
!: 10000010